{
  "version": 1,
  "name": "Warehouse2020",
  "description": "20x20 Simple warehouse",
  "dimensions": {
    "width": 20,
    "height": 20
  },
  "grid": [
    "####################",
    "#..................#",
    "#.###.##.##.##.###.#",
    "#.###.##.##.##.###.#",
    "#.###.##.##.##.###.#",
    "#..................#",
    "#.###.########.###.#",
    "#.###.########.###.#",
    "#..................#",
    "#.###.########.###.#",
    "#.###..........###.#",
    "#.....########.....#",
    "#.###.########.###.#",
    "#..................#",
    "#.###.#.####.#.###.#",
    "#.###.#.####.#.###.#",
    "#.###.#.####.#.###.#",
    "#..................#",
    "#.################.#",
    "####################"
  ],
  "agents": [
    {
      "id": 0,
      "x": 1,
      "y": 1
    }
  ],
  "boxes": [
    {
      "id": 0,
      "x": 11,
      "y": 10
    }
  ],
  "targets": [
    {
      "id": 0,
      "x": 5,
      "y": 17
    }
  ],
  "agent_goals": {
    "0": 0
  }
}